5 3 2 3 6 1 1 2 1 3 3 3 2 2 3 3 5 7 0 9 
0 6 3 6 6 2 3 3 4 3 3 3 3 4 4 5 5 5 3 5 
9 3 3 6 7 3 3 6 7 4 5 5 5 3 4 5 6 5 9 5 
0 0 0 0 0 0 0 0 7 0 0 0 0 0 0 0 0 0 7 3 
0 0 0 0 0 0 0 4 4 2 0 0 0 0 0 0 3 1 8 4 
0 0 0 1 6 0 2 4 5 7 3 5 7 0 0 1 5 2 3 6 
0 0 3 2 7 0 7 5 6 7 3 6 8 6 2 4 2 4 0 0 
0 1 9 0 3 5 8 3 8 4 6 0 3 6 2 5 2 3 0 9 
0 0 1 0 5 9 5 7 5 0 1 8 0 8 2 4 0 3 0 8 
0 0 2 1 3 1 1 5 1 4 5 4 0 6 3 1 0 5 3 6 
0 0 0 0 3 0 0 0 0 0 0 0 1 4 0 2 2 7 3 2 
0 0 0 0 0 0 0 0 0 0 0 3 0 4 2 3 1 0 4 4 
0 0 3 3 3 9 3 4 0 0 0 0 0 2 4 0 0 0 4 6 
0 0 8 7 9 5 5 8 5 6 5 0 3 0 0 0 0 0 3 5 
0 0 0 0 0 0 0 0 0 0 0 0 0 0 0 0 0 0 6 7 
